[lea]
lea r0 hw
R0 0x0000
R1 0x0000
R2 0x0000
R3 0x0000
R4 0x0000
R5 0x0000
R6 0x0000
R7 0xfdff
PC 0x3000
CC 0b000
[puts]
puts
R0 0x3003
R1 0x0000
R2 0x0000
R3 0x0000
R4 0x0000
R5 0x0000
R6 0x0000
R7 0xfdff
PC 0x3001
CC 0b001

Reached::Halt
[halt]
halt
R0 0x3003
R1 0x0000
R2 0x0000
R3 0x0000
R4 0x0000
R5 0x0000
R6 0x0000
R7 0xfdff
PC 0x3002
CC 0b001
Reached::Halt
